11:11
00,00,00,00,00,00,00,00,00,00,00
00,02,00,00,00,00,00,00,00,02,00
00,00,00,00,00,00,00,00,00,00,00
00,00,00,00,00,00,00,00,00,00,00
00,00,00,00,00,00,00,00,00,00,00
00,00,00,03,00,08,00,00,00,00,06
00,00,00,00,00,00,00,00,00,00,06
00,00,00,00,00,0a,00,00,00,00,06
00,06,00,00,00,00,00,00,00,00,06
00,02,00,00,00,00,00,00,00,02,06
00,00,00,00,00,00,00,00,00,00,06
