12:12
03,00,00,00,00,00,00,00,00,00,00,00
02,02,02,00,02,00,02,02,02,02,06,06
00,00,00,00,02,64,02,00,00,02,06,06
00,08,00,00,02,04,02,00,00,02,06,06
00,00,00,00,02,04,02,00,00,02,06,06
00,00,00,0a,02,02,02,00,00,02,06,06
00,00,00,00,00,00,00,00,00,02,06,06
00,12,04,12,00,00,00,00,00,02,06,06
00,12,12,12,00,00,00,00,00,02,06,06
00,00,00,00,35,25,15,45,55,02,06,06
14,02,02,02,02,02,02,02,02,02,54,06
06,00,00,00,00,00,00,00,00,00,00,06
