12:12
03,00,00,04,04,04,04,04,04,04,04,04
00,02,04,12,04,02,02,04,12,04,02,04
00,04,04,04,04,04,04,04,04,04,04,04
04,12,04,00,00,00,00,00,00,04,12,04
04,04,04,00,00,00,00,00,00,04,04,04
04,02,04,00,00,35,15,00,00,04,02,04
04,02,04,00,00,15,35,00,00,04,02,04
04,04,04,00,00,00,00,00,00,04,04,04
04,12,04,00,00,00,00,00,00,04,12,04
04,04,04,04,04,04,04,04,04,04,04,00
04,02,04,12,04,02,02,04,12,04,02,00
04,04,04,04,04,04,04,04,04,00,00,03
