11:11
03,00,04,04,04,04,04,04,04,04,04
00,02,04,12,04,02,04,12,04,02,04
04,04,04,04,04,04,04,04,04,04,04
04,12,04,02,04,12,04,02,04,12,04
04,04,04,04,00,00,00,04,04,04,04
04,02,04,12,00,02,04,12,04,02,04
04,04,04,04,00,00,00,04,04,04,04
04,12,04,02,04,12,04,02,04,12,04
04,04,04,04,04,04,04,04,04,04,04
04,02,04,12,04,02,04,12,04,02,00
04,04,04,04,04,04,04,04,04,00,03
