12:12
00,00,00,00,00,00,00,00,00,00,00,00
00,00,00,00,00,00,00,00,00,00,00,00
00,00,00,00,00,00,00,00,00,00,00,00
00,00,00,00,00,00,00,02,12,02,00,00
00,00,02,12,12,12,12,12,08,12,02,00
00,00,12,03,00,00,00,04,00,00,12,00
00,00,02,12,12,12,12,00,12,12,02,00
00,00,00,00,00,00,12,0a,12,00,00,00
00,00,00,00,00,00,02,12,02,00,00,00
00,00,00,00,00,00,00,00,00,00,00,00
00,00,00,00,00,00,00,00,00,00,00,00
00,00,00,00,00,00,00,00,00,00,00,00
