12:12
00,00,00,00,00,00,00,00,00,00,00,00
00,00,00,00,00,12,00,00,00,00,00,00
00,00,00,00,12,03,12,00,00,00,00,00
00,00,00,00,02,00,02,12,00,00,00,00
00,00,00,00,02,00,08,64,12,00,00,00
00,00,00,00,02,00,02,12,00,00,00,00
00,00,00,12,02,00,02,00,00,00,00,00
00,00,12,00,04,06,02,00,00,00,00,00
00,00,12,06,12,0a,02,00,00,00,00,00
00,00,12,00,04,55,02,00,00,00,00,00
00,00,00,12,02,02,02,00,00,00,00,00
00,00,00,00,00,00,00,00,00,00,00,00
