09:09
03,00,00,00,00,00,00,00,04
00,00,00,00,00,00,00,04,00
00,00,00,00,00,00,04,00,00
00,00,00,12,00,04,00,00,00
00,00,00,00,04,00,00,00,00
00,00,00,04,00,12,00,00,00
00,00,04,00,00,00,00,00,00
00,04,00,00,00,00,00,00,00
04,00,00,00,00,00,00,00,03
