12:12
00,00,00,00,00,00,00,00,00,00,00,00
00,00,00,00,00,00,00,00,00,00,00,00
00,00,00,00,00,00,00,00,00,00,00,00
00,00,00,00,00,00,00,00,00,00,00,00
00,00,02,12,12,12,12,12,12,02,00,00
00,00,12,03,00,00,00,00,09,12,00,00
00,00,02,12,12,12,12,12,12,02,00,00
00,00,00,00,00,00,00,00,00,00,00,00
00,00,00,00,00,00,00,00,00,00,00,00
00,00,00,00,00,00,00,00,00,00,00,00
00,00,00,00,00,00,00,00,00,00,00,00
00,00,00,00,00,00,00,00,00,00,00,00
Arnaud forêt :
12,12,12,12,12,12,12,12,12,12,12,12
12,03,12,12,0a,12,00,00,00,12,02,12
12,00,00,12,00,00,00,12,00,00,00,12
12,12,00,12,12,12,12,12,12,12,00,12
12,12,00,12,00,00,06,00,00,00,00,12
12,00,00,12,00,02,00,02,00,02,00,12
12,00,12,00,00,00,00,00,04,06,12,12
12,00,00,02,00,02,00,02,00,02,12,12
12,12,00,04,00,00,00,00,04,00,00,12
12,12,12,02,00,02,00,02,00,02,08,12
12,12,12,12,00,00,04,00,06,00,12,12
12,12,12,12,12,12,12,12,12,12,12,12
Début :
00,00,00,00,00,00,00,00,00,00,00,00
00,00,00,00,00,00,00,00,00,00,00,00
00,00,00,00,00,00,00,00,00,00,00,00
00,00,00,00,00,00,00,00,00,00,00,00
00,00,02,12,12,12,12,12,12,02,00,00
00,00,12,03,00,00,00,00,09,12,00,00
00,00,02,12,12,12,12,12,12,02,00,00
00,00,00,00,00,00,00,00,00,00,00,00
00,00,00,00,00,00,00,00,00,00,00,00
00,00,00,00,00,00,00,00,00,00,00,00
00,00,00,00,00,00,00,00,00,00,00,00
00,00,00,00,00,00,00,00,00,00,00,00
