12:12
00,00,00,00,00,00,00,00,00,00,00,00
00,00,00,00,00,00,00,00,00,00,00,00
00,00,00,00,00,00,00,00,00,00,00,00
00,00,00,00,00,00,00,00,00,00,00,00
00,00,02,12,12,12,12,12,12,02,00,00
00,00,12,03,00,00,00,04,00,12,00,00
00,00,02,12,12,12,12,00,12,02,00,00
00,00,00,00,00,00,12,09,12,00,00,00
00,00,00,00,00,00,02,12,02,00,00,00
00,00,00,00,00,00,00,00,00,00,00,00
00,00,00,00,00,00,00,00,00,00,00,00
00,00,00,00,00,00,00,00,00,00,00,00
